FFPPPPPPPPPPPPPPPPPPPPPPP
RRRRRRRRRRRRRRRRRRRRRRRRR
FFPMMRMMPPPPPPPPPPPPFFFRP
PPPPPRPPPPPPPPPPPPPPFFFRP
PPPRRRRRRRRRRRRRRRPPPPPRP
PRRRMRPPPPPPPPRPPRMMMMMRP
PRPPPRPMMMMMMPRPPRMMMMMRP
PRHPPRPPPPPPPPRPPRPPPPPRP
PRPPPRRRRRRRRRRRRRPPPFFRP
PRPPPRPMPRRFFMFFFRPPPFFRP
PRMMPRPMPPRFFMFFFRPPPPPRP
PRMMPRPMMMRMMMMMMRPPPPPRP
PRPPPRPPPPRFFFMFFRFFPPPRP
PRPPPRPPPPRFFFMFFRFFPPPRP
PRPPPRRRRRRRRRRRRRRRRRRRP
PRPPRRMMMPRPPMMPPRPPPPPRP
PRFRRPPPPPRPMMPPRRPPPPPRP
PRFRPPPRRRRPMPPRRPPMMPPRP
PRFRPPPRMMPPMPRRPPPMMPPRP
PRRRRRRRPPPPMRRRRPPMMPPRP
PPPRPPPRRRRRRRPPRRRRHRRRP
PPPRPPPMMMMMPRPPPPPPPPPRP
FPPRPPPPPPPPPRPPPMMMMMMRP
FRRRRRRRRRRRRRRRRRRRRRHRP
FFFPPPPPPPPPPPPPPPPPPPPPP