R P P P P P P P P P P P P P P P P P P P P P P P P P P P P P P P P P P P P P P P P P R R R R R P P P P P P P P P P P P P P P P F P P P P P P P P P P P P P P P P P P P P P P P P P P P P P P P P P P P P 
H R R R R R P P P P P P P P P P P P P P P P P P P P P P P P P R R R R R R R R R R R R P R P R R R R R R R R R R R P P P P P P F P P P P P P P P P P P P P P P P P P P P P P P P P P P P P P P P P P P P 
P P P P P R P P P P P P P P P P P P P P P P P P P P P P P P R R P P P P P P P P P P P P R P P P P P P P P P P P R P P P P P P F P P P P P P P P P P P P P P P P P P P P P P P P P P P P P P P P P P P P 
P P P P P R P P P P P P P P P P P P P P P P P P P P P P P P R P P P P P P P P P P P P P R P P P P P P P P P P P R P P P P P M M M P P P P P P P P P P P P P P P P P P P P P P P P P P P P P P P P P P P 
P P P P P R R R R R R R R R R R R R R R R R R P P P P P P P R P P P P P P P P M M M M M R M M M M M P P P P P P R P P H P M M M M M P P P P P P P P P P P P P P P P P P P P P P P P P P M M M P P P P P 
P P P P P R H P P P P P P P P P P P M M M M R R R R R R R R R R P P P P P P P M M M M M R M M M M M P P P P P P R P P P P M M M M M P P P P P P P P P P P P P P P P P P P P P P P P P P M M M P P P P P 
P P P P P R P P P P P P P P P P P P M M M M R P P P P P P P P R P P P P P P P M M M M M R M M M M M P P P P P P R R R R R R R R R R R R R R R R R R R R R R R R R R R R R R R R R R R R R M M P P P P P 
P P P P P R P P P P P P P P P P P P M M M M R P P P P P P P P R P P P P P P P M M M M M R M M M M M P P P P P P R P P P P P P F P P P P P P P P P P P P P P P P P P P P P P P P P P P P R P P P P P P P 
P P P P P R P P P P P P P P P P P P M M M M R P P P P P P P P R P P P P P P P M M M M M R M M M M M P P P P P P R P P P P P P F P P P P P P P P P P P P P P P P P P P P P P P P P P P P R P P P P P P P 
P P P P P R P P P P P P P P P P P P P P P P R P P P P P P P P R P P P P P P P M M M M R R M M M M M P P P P P P R P P P P P P F P P P P P P P P P P P P P P P P P P P P P P P P P P P P R P P P P P P P 
P P P P P R P P P P P P P P P P P P P P P P R P P P P P P P P R P P P P P P P M M M M R M M M M M M P P P P P P R P P P P P P F P P P P P P P P P P P P P P P P P P P P P P P P P P P P R P P P P P P P 
P P P P P R P P P P P P P P P P P P P P P P R P P P P P P P P R P P P P P P P M M M M R M M M M M M P P P P P P R P P P P P P F P P P P P P P P P P P P P P P P P P P P P P P P P P P P R P P P P P P P 
P P P P P R P P P P P P P P P P P P P P P P R P P P P P P P P R P P P P P P P P P P P R P P P P P P P P P P P P R P P P P P P F P P P P P P P P P P P P P P P P P P P P P P P P P P P P R P P P P P P P 
P P P P P R R R R R R R R R R P P P P P P P R P P P P P P P P R P P P P P P P P P P P R P P P P P P P P P P P P R P P P P P P F F F F F F F F F F F F F F F F F F F F F F F F F F F F F R F F F F P P P 
P P P P P R P P P R P P P P R P P P P P P P R P P P P P P P P R P P P P P P P P P P P R P P P P P P P P P P P P R P P P P P P P P P P P P P P P P P P P P P P P P P P P P P P P P P P P R P P P F P P P 
P P P P P R P P P R P P P P R P P P P P P P R P P P P P P P P R P P P P P P P P P P P R P P P P P P P P P P P P R P P P P P P P P P P P P P P P P P P P P P P P P P P P P P P P P P P P R P P P F P P P 
P P P P P R P P P R P P P P R P P P P P P P R P P P P M M M M R P P P P P P P P P P P R P P P P P P P P P P P P R P P P P P P P P P P P P P P P P P P P P P P P P P P P P P P P P P P P R P P P F P P P 
P P P P P R P P P R P P P P R M M M M M M M R P P P P M M M M R P P P P P P P P P P P R P P P P P P P P P P P P R P P P P P P P R R R R R R R R R R R R R R R R R R R R R R R P P P P P R P P P F P P P 
P P P P P R P P P R P P P P R M M M M M M M R P P P P M M M M R R R R R R R R R R R R R R R R R R R R R R R R R R P P P P P P P R P P P P P P P P P M M M P P P P P P P P P R P P P P P R P P P F P P P 
P P P P P R P P P R P P P P R M M M M M M M R P P P P M M M P P P P P P P P P P P P P R P P P M M M M M P P P P R P P P P P P P R P P P P P P P P P M M M P P P P P P P P P R P P P P P R P P P F P P P 
P P P P P R P P P R P P P P R P P P P P P P R P P P P M M M P P P P P P P P P P P P P R P P P M M M M M P P P P R P P P P P P P R P P P P P P P P P M M M P P P P P P P P P R P P P P P R P P P F P P P 
P P P P P R P P P R P P P P R P P P P P P P R P P P P M M M P P P P P P P P P P P P P R P P P M M M M M P P P P R P P P P P P P R R R R R R R R R R R R R R R R P P P P P P R P P P P P R P P P F P P P 
P P P P P R P P P R P P P P R P P P P P P P R P P P P M M M P P P P P P P P P P P P P R P P P M M M M M P P P P R P P P P P P P P P P P P P P P P P P P P P P R P P P P P P R P P P P P R P P P F P P P 
P P P P P R P P P R P P P P R P P P P P P P R P P P P M M M P P P P P P P P P P P P P R P P P M M M M M P P P P R P P P P P P P P P P P P P P P P P P P P P P R P P P P P P R P P P P P R P P P F P P P 
P P P P P R P P P R P P P P R P P P P P P P R P P P P M M M P P P P P P P P P P P P P R P P P M M M M M P P P P R P P P P P P P P P P P P P P P P P P P P P P R P P P P P P R P P P P P R P P P F P P P 
P P P P P R P P P R P P P P R R R R R R R R R P P P P M M M R R R R R R R R R R R R R R P P P M M M M M P P P P R P P P P P P P P P P P P P P P P P P P P P P R P P P P P P R P P P P P R P P P F P P P 
P P P P P R P P P R P P P P P P P P P P P P R P P P P P P P R P P P P P P P P P P P P R P P P M M M M M P P P P R R R R R R R R R R R R R P P P P P P P P P P R P P P P P P R P P P P P R P P P F P P P 
P P P P P R P P P R P P P P P P P P P P P P R P P P P P P P R P P P P P P P P P P P P R P P P M M M M M P P P P R P P P P P P P P P P P R P P P P P P P P P P R P P P P P P R P P P P P R P P P F P P P 
P P P P P R P P P R P P P P P P P P P P P P R P P P P P P P R P P P P P P P P P P P P R P P P M M M M M P P P P R P P P P P P P P P P P R P P P P P P P P P P R P P P P P P R P P P P P R P P P F P P P 
R R R R R R P P P R P P P P P P P P P P P P R P P P P P P P R P P P P P P P P P P P P R P P P M M M M M P P P P R P P P P P P P P P P P R P P P P P P P P P P R P P P P P P R P P P P P R P P P F P P P 
P P P P P R P P P R P P P P P P P P P P P P R P P P P P P P R P P P P P P P P P P P P R P P P M M M R R R R R R R P P P P P P P P P P P R P P P P P P P P P P R P P P P P P R P P M M P R P P P F P P P 
P P P P P R P P P R P P P P P P P R R P P P R P P P P P P P R P P P P R R R R R R R R R R R R R R R R M M M M M M M M M M M M M M M M M R P P P P P P P P P P R P P P P P P R P P M M P R P P P F P P P 
P P P P P R P P P R P P P P P P P R P P P P R P P P P P P P R P P P P R P P P R P P P P P P P M M M M M M M M M M M M M M M M M M M M M R P P P P P P P P P P R P P P P P P R P P M M P R P P P F P P P 
P P P P P R P P P R P P P P P P P R P P P P R P P P P P P P R P P P P R P P P R P P P P P P P M M M M M M M M M M M M M M M M M M M M M R P P P P P P P P P P R P P P P P P R P P M M P R P P P F P P P 
P P P P P R P P P R P P P P P P P R P P P P R P P P P P P P R P P P P R P P P R P P P P P P P M M M M M M M M M M M M M M M M M M M M M R P P P P P P P P P P R P P P P P P R P P M M P R P P P F P P P 
P P P P P R P P P R P P P P P P P R P P P P R P P P P P P P R P P P P R P P P R P P P P P P P M M M M M M M M M M M M M M M M M M M M M R P P P P P P P P P P R P P P P P P R P P M M P R P P P F P P P 
P P P P P R P P P R P P P P P P P R P P P P R P P P P P P P R P P P P R P P P R P P P P P P P P P P P P P P P P P P P P P P P P P P P P R P P P P P P P P P P R P P P P P P R P P M M P R P P P F P P P 
P P P P P R P P P R R R R R R R R R P P P P R P P P P P P P R P P P P R P P P R P P P P P P P P P P P P P P P P P P P P P P P P P P P P R R R R R R R R R R R R R R P P P P R R P M M P R P P P F P P P 
P P P P P R P P P P P P P P P P P P P P P P R P P P P P P P R R R R R R P P P R P P P P P P P P P P P P P P P P P P P P P P P P P P P P R P P P P P P P P P P P P R R P P P P R P M M P R P P P F P P P 
P P P P P R P P P P P P P P P P P P P P P P R P P P P P P P R P P P P P P P P R P P P P P P P P P P P P P P P P P P P P P P P P P P P P R P P P P P P P P P P P P P R P P P P R M M M M R P P P F P P P 
P P P P P R P P P P P P P P P P P P P P P P R P P P P P P P R P P P P P P P P R P P P P P P P P P P P P P P P P P P P P P P P P P P P P R P P P P P P P P P P P P P R P P P P R M M M M R P P P F P P P 
P P P P P R P P P P P P P P P P P P P P P P R P P P P P P P R P P P P P P R R R R R P P P P P P P P P P P P P P P P P P P P P P P P P P R P P P P P P P P P P P P P R R P P P R M M M M R P P P F P P P 
P P P P P R P P P P P P P P P P P P P P P P R P P P P P P P R R P P P P R R P P P R R P P P P P P P P P P P P P P P P P P P P P P P P P R P P P P P P P P P P P P P P R P P P R P P P P R P P P F P P P 
P P P P P R P P P P P P P P P P P P P P P P R P P P P P P P P R P P P P R P P P P P R P P P P P P P P P P P P P P P P P P P P P P P P P R P P P P P P P P P P P P P P R P P P R P P P P R P P P F P P P 
P P P P P R R R R R R R R R R R R R R R R R R R R R R R R R R R R R R R R P P F P P R R R R R R R R R R R R R R R R R R R R R R R R R R R R R R R R R R R R R R R P P R R P P R R R R R R P P P F P P P 
P P P P P R P P P P P P P P P P P P P P P P R P P P P P P P P R P P P P R P P P P P R P P P P P P P M M M P P P P P P R P P P P P P P P P P P P P P P P P P P P R P P P R R R R P P P P R P P P F P P P 
P P P P P R P P P P P P P P P P P P P P P P R P P P P P P P P R P P P P R R P P P R R P P P P P P P M M M P P P P P P R P P P P P P P P P P P P P P P P P P P P R P P P P P P P P P P P R P P P F P P P 
P P P P P R P P P P P P P P P P P P P P P P R P P P P P P P P R P P P P P R R R R R P P P P P P P P M M M P P P P P P R P P P P P P P P P P P P P P P P P P P P R P P P P P P P P P P P R P P P F P P P 
P P P P P R P P P P P P P P P P P P P P P P R P P P P P P P P R P P P P P P P R P P P P P P P P P P M M M P P P P P P R P P P P P P P P P P P P P P P P P P P P R P P P P P P P P P P P R P P P F P P P 
P P P P P R P P P P P P P P P P P P P P P P R P P P P P P P P R P P P P P P P R P P P P P P P P P P M M M P P P P P P R P P P P P P P P P P P P P P P P P P P P R P P P P P P P P P P P R P P P F P P P 
P P P P P R P P P P P P P P P P P P P P P P R P P P P P P P P R P P P P P P P R R R R P P P P P P P M M M P P P P P P R P P P P P P P P P P P P P P P P P P P P R P P P P P P P P P P P R P P P F P P P 
P P P P P R M M M M M M M M M M M M M M M M R P P P P P P P P R P P P P P P P P P P R P P P P P P P M M M M M M M M M R R R R R R R R R R R R R R R R R R R R R R R R R R R R R R R R R R P P P F P P P 
P P P P P R M M M M M M M M M M M M M M M M R P P P P P P P P R P P P P P P P P P P R P P P P P P P M M M M M M M M M R P P P P P P P P P P P P P P P R P P P P R P P P P P P P P P R P P P P P F P P P 
P P P P P R M M M M M M M M M M M M M M M M R P P P P P P P P R P P P P P P P P P P R P P P P P P P M M M M M M M M M R P P P P P P P P P P P P P P P R P P P P R P P P P P P P P P R P P P P P F P P P 
P P P P P R M M M M M M M M M M M M M M M M R P P P P P P P P R P P P P P P P P P P R P P P P P P P P P P P P P P P P R P P P P P P P P P P P P P P P R P P P P R P P P P P P P P P R P P P P P F P P P 
P P P P P R P P P P P P P P P P P P P P P P R P P P P P P P P R H P P P P P P P P P R P P P P P P P P P P P P P P P P R P P P P P P P P P P P P P P R R P P P P R P P P P P P P P P R P P P P P F P P P 
P P P P P R P P P P P P P P P P R R R R R R R R R R R R R R R R R R R P P P P P P P R P P P P P P P P P P P P P P P P R P P P P R R R R R R P P P P R P P P P P R P P P P P P P P P R P P P P P F P P P 
P P P P P R P P P P P P P P R R R P P P P P R P P P P P P P P P P P R P P P P P P P R P P P P P P P P P P P P P P P P R P P P P R P P P P R R R R R R P P P P P R P P P P P P P P P R P P P P P F P P P 
F P P P P R P P P P P P P R R P P P P P P P R P P P P P P P P P P P R P P P P P P P R P P P P P P P P P P P P P P P P R P P P P R P P P P P P P P P P P P P P P R P P P P P P P P P R P P P P P F P P P 
F F P P P R P P P P P P R R P P P P P P P P R P P P P P P P P P P P R R R R R R P P R P P P P P P P P P P P P P P P P R P P P P R P P P P P P P P P P P P P P P R P P P P P P P P P R P P P P P F P P P 
F F F P P R P P P P P P R P P P P P P P P P R P P P P P P P P P P P M M M P P R P P R P P P P P P P P P P P P P P P P R P P P P R P P P P P P P P P P P P P P P R P P P P P P P P P R P P P P P F P P P 
F F F P P R P P P P P P R P P P P P P P P P R P P P P P P P P P P P M M M P P R P P R P P P P P P P P P P P P P P P P R P P P P R R R R R R R R R R R R R R R R R P P P P P P P P P P P P P P P F P P P 
F F F P P R P P P P P P R P P P P P P P P P R P P P P P P P P P P P M M M P P R P P R P P P P P P P P P P P P P P P P R P P P P R M M M M M M P P P P P P P P P P P P P P P P P P P P P P P P P F P P P 
F F F P P R P P P P P P R P P P P P P P P P R P P P P P P P P P P P M M M P P R R R R R R R R R R R R R R R P P P P P R P P P P R M M M M M M P P P P P P P P P P P P P P P P P P P P P P P P P F P P P 
F F F F P R P P P P P P R P P P P P P P P P R P P P P P P P P P P P M M M P P P P P R P P P P P P P P P P R P P P P P R P P P P R M M M M M M P P P P P P P P P P P P P P P P P P P P P P P P P F P P P 
F F F F P R R R R R R R R R R R R R R R R R R R R R R R M M M M M M M M M P P P P P R P P P P P P P P P P R P P P P P R P P P P R M M M M M M P P P P P P P F F F F F P P P P P P P P P P P P P F P P P 
F F F F P P P P P P P P R P P P P P P P P P P P P P P R M M M M M M M M M P P P P P R P P P P P P P P P P R P P P P P R P P P P R M M M M M M P P P P P P F F F F F F P P P P P P P P P P P P P F P P P 
F F F F P P P P P P P P R P P P P P P P P P P P P P P R M M M M M M M M M P P P P P R P P P P P P P P P P R P P P P P R P P P P R P P P P P P P P P P P F F F F F F F F F F F F F F F F F F F F F P P P 
F F F F P P P P P P P P R P P P P P P P P P P P P P P R P P P P P P P P P P P P P P R P P P P P P P P P P R P P P P P R P P P H R P P P P P P P P P P P F F F F F F F P P P P P P P P P P P P P P P P P 
F F F F P P P P P P P P R P P P P P P P P P P P P P P R P P P P P P P P P P P P P P R P P P P P P P P P P R R R R R R R R R R R R P P P P P P P P P P F F F F F F F F P P P P P P P P P P P P P P P P P 
F F F F P P P P P P P P R P P P P P P P P P P P P P P R P P P P P P P P P P P P P P R P P P P P P P P P P P P P P P P R P P P P R P P P P P P P P F F F F P P P P P P P P P P P P P R P P P P P P P P P 
F F F F F P P P P P P P R P P P P P P P P P P P P P P R R R R R R R R R R R R R R R R P P P P P H P P P P P P P P P P R P P P P R P P P P P P P P F F F P P P P P P P P P P P P P P R P P P P P P P P P 
F F F F F P P P P P P P R P P P P P P P P P P P P P P R P P P P P P P P P P P P P P R P P P P P P P P P P P P P P P P R P P P P R P P P P P P P P P P P P P P P P P P P P P P P P P R P P P P P P P P P 
F F F F F P P P P P P P R P P P P P P P P P P P P P P R P P P P P P P P P P P P P P R P P P P P P P P P P P P P P P P R P P P P R P P P P P P P P P P P P P P P P P P P P P P P P P R P P P P P P P P P 
F F F F F P P P P P P P R P P P P P P P P P P P P P P R P P P P P P P P P P P P P P R R R R R R R R R R R R R R P P P R P P P P R P P P P P P P P P P P P P P P P P H P P P P P P P R P P P P P P P P P 
F F F F F P P P P P P P R P P P P P P P P P P P P P P R P P P P P P P P P P P P P P R P P P P P P P P P P P P R P P P R P P P P R P P P P P P P P P P P P P P P P P P P P P P P P P R P P P P P P P P P 
F F F F F F F F F F F F R F F F F F F F F F F F F F F R F F F F F F F F F F F F F F R F F F F F F F F F F P P R P P P R R P P P R P P P P P P P P P P P P P P P P P P P P P P P P P R P P P P P P P P P 
F F F F F P P P P P P P R P P P P P P P P P P P P P P R P P P P P P F P P P P P P P R P P P P P P P P P F P P R P P P P R P P P R R R R R R R R R R R R R R R R R R R R R R R R R R R R R R P P P P P P 
F F F F F P P P P P P P R P P P P P P P P P P P P P P R P P P P P P F P P P P P P P R P P P P P P P P P F P P R R R R R R P P P P P P P P P P P M M M P P P P P P P P P P P R P P P P P P R P P P P P P 
F F F F F P P P P P P P R P P P P P P P P P P P P P P R P P P P P P F P P P P P P P R P P P P P P P P P F P P P P P P P R P P P P P P P P P P P M M M P P P P P P P P P P P R P P P P P P R P P P P P P 
F F F F F P P P P P P P R P P P P P P P P P P P P P P R P P P P P P F P P P P P P P R P P P P P P P P P F P P P P P P P R P P P P P P P P P P P M M M P P P P P P P P P P P R P P P P P P R P P P P P P 
F F F F F P P P P P P P R P P P P P P P P P P P P P P R P P P P P F F P P P P P P P R P P P P P P P P P F P P P P P P P R P P P P P P P P P P P M M M P P P P P P P P P P P R P P P P P P R P P P P P P 
F F F F P P P P P P P P R R R R R R R R R R R R R R R R P P P P P F P P P P P P P P R P P P P P P P P P F P P P P P P P R P P P P P P R R R R R R R R R R R R R R P P P P P R P P P P P P R P P P P P P 
F F F F P P P P P P P P R P P P P P P R P P P R P P P R P P P P F F P P P P P P P P R P P P P P P P P P F P P P P P P P R P P P P P P R P P P P P P R P P P P P R P P P P P R P P P P P P R P P P P P P 
F F F F P P P P P P P P R P P P P P P R P P P R P P P R P P P P F P P P P P P P P P R P P P M M M M M M M M M M M P P P R P P P P P P R P P P P P P R P P P P P R P P P P P R P P P P P P R P P P P P P 
F F F P P P P P P P P P R P P P P P P R P P P R P P P R P P P P F P P P P P P P P P R P P P M M M M M M M M M M M P P P R P P P P P P R P P P P P P R P P P P P R R R R R R R P P P P P P R P P P P P P 
F F P P P P P P P P P P R P P P P P P R P P P R P P P R P P P P F P P P P P P P P P R P P P M M M M M M M M M M M P P P R P P P P P P R P P P P P P R P P P P P P P P P P P P P P P P P P R P P P P P P 
F F P P P P P P P P P P R P P P R R R R P P R R R P P R P P P P F P P P P P P P P P R P P P P P P P P P F P P P P P P P R P P P P P P R P P P P P P R P P P P P P P P P P P P P P P P P P R P P P P P P 
F P P P P P P P P P P P R P P P P P P P P P P R P P P R P P P P F P P P P P P P P P R P P P P P P P P P F P P P P P P P R P P P P P P R P P P P P P R P P P P P P P P P P P P P P P P P P R P P P P P P 
P P P P P P P P P P P P R P P P P P P P P P P P P P P R P P P P F P P P P P P P P P R P P P P P P P P P F P P P P P P P R P P P P P P R P P P P P P R R R R R R R R R R P P P P P P P P P R P P P P P P 
R R R R R R R R R R R R R R R R R R R R R R R R R R R R R R R R R R R R R R R R R R R P P P P P P P P P F P P P P P P P R P P P P P P R P P P P P P P P P P P P P P P R P P P P P P P P P R P P P P P P 
P P P P P P P P P P P P R P P P P P P P P P P P P P P P P P P P F P P P P P P P P P R P P P P P P P P P F P P P P P P P R R R R R R R R P P P P P P P P P P P P P P P R P P P P P P P P P R P P P P P P 
P P P P P P P P P P P P R P P P P P P P P P P P P P P P P P P P F P P P P P P P P P R P P P P P P P P P F P P P P P P P P P P P P P P P P P P P P P P P P P P P P P P R P P P P P P P P P R P P P P P P 
P P P P P P P P P P P P R P P P P P P P P P P P P P P P P P P P F P P P P P P P P P R P P P P P P P P P F P P P P P P P P P P P P P P P P P P P P P P P P P P P P P P R P P P P P P P P P R P P P P P P 
P P P P P P P P P P P P R P P P P P P P P P P P P P P P P P P P F P P P P P P P P P R P P P P P P P P P F P P P P P P P P P P P P P P P P P P P P P P P P P P P P P P R P P P P P P P P P R P P P P P P 
P P P P P P P P P P P P R P P P P P P P P P P P P P P P P P P P P P P P P P P P P P R R R R R R R R R R R R R R R R R R R R R R R R R R R R R R R R R R R R R R R R R R R R R R R R R R R R P P P P P P 
P P P P P P P P P P P P R P P P P P P P P P P P P P P P P P P P P P P P P P P P P P P P P P P P P P P P F P P P P P P P P P P P P P P P P P P P P P P P P P P P P P P P P P P P P P P P P P P P P P P P 
P P P P P P P P P P P P R P P P P P P P P P P P P P P P P P P P P P P P P P P P P P P P P P P P P P P P F P P P P P P P P P P P P P P P P P P P P P P P P P P P P P P P P P P P P P P P P P P P P P P P 
P P P P P P P P P P P P R P P P P P P P P P P P P P P P P P P P P P P P P P P P P P P P P P P P P P P P F P P P P P P P P P P P P P P P P P P P P P P P P P P P P P P P P P P P P P P P P P P P P P P P 
P P P P P P P P P P P P R P P P P P P P P P P P P P P P P P P P P P P P P P P P P P P P P P P P P P P P F P P P P P P P P P P P P P P P P P P P P P P P P P P P P P P P P P P P P P P P P P P P P P P P 
