FFPPPPPPPPPPPPPPPPPPPPPPP
RRRRRRRRRRRRRRRRRRRRRRRRR
FFPMMRMMPPPPPPPPPPPPFFFRP
PPPPPRPPPPPPPPPPPPPPFFFRP
PPPRRRRRRRRRRRRRRRPPPPPRP
PRRRMRPPPPPPPPRPPRMMMMMRP
PRPPPRPMMMMMMPRPPRMMMMMRP
PRPPPRPPPPPPPPRPPRPPPPPRP
PRPPPRRRRRRRRRRRRRPPPFFRP
PRPPPRPMPPRFFMFFFRPPPFFRP
PRMMPRPMPPRFFMFFFRPPPPPRP
PRMMPRPMMMRMMMMMMRPPPPPRP
PRPPPRPPPPRFFFMFFRFFPPPRP
PRPPPRPPPPRFFFMFFRFFPPPRP
PRPPPRRRRRRRRRRRRRRRRRRRP
PRPPRRMMMPRPPMMPPRPPPPPRP
PRFRRPPPPPRPMMPPRRPPPPPRP
PRFRPPPRRRRPMPPRRPPMMPPRP
PRFRPPPRMMPPMPRRPPPMMPPRP
PRRRRRRRPPPPMRRRRPPMMPPRP
PPPRPPPRRRRRRRPPRRRRRRRRP
PPPRPPPMMMMMPRPPPPPPPPPRP
FPPRPPPPPPPPPRPPPMMMMMMRP
FRRRRRRRRRRRRRRRRRRRRRRRP
FFFPPPPPPPPPPPPPPPPPPPPPP
